20 30
22222222222222222222
21111111111111111112
21333333333333333312
21333333333333333312
21333333333333333312
21333333333333333312
21333333333333333312
21333333333333333312
21333333333333333312
21333333333333333312
21332222222222223312
21332222222222223312
21332222222222223312
21332222222222223312
21332222222222223312
21332222222222223312
21332222222222223312
21332222222222223312
21332222222222223312
21332222222222223312
21333333333333333312
21333333333333333312
21333333333333333312
21333333333333333312
21333333333333333312
21333333333333333312
21333333333333333312
21333333333333333312
21111111111111111112
22222222222222222222