23 32
21222222222222222222222
21211211221211211111112
21211211111211212221212
21212222121121111121212
21211211121112121121212
21211112121121121211212
21222222122111211112112
21111111111212111221112
21112222221221121111212
21212111211111111222212
21212121221222222121222
21212123233333332121112
21212123333333332122222
21222123323333332111112
21211123333323332222212
21121123333333332111112
21112122221222222122222
21112111121211121111112
21111122221222122222212
21222111111111111211112
21111122221222221112112
21222111121211121221212
21112122121212121211112
21212121111212222222212
21212121221211111211212
21212121121211111221212
21222122221211111211112
21111111111212222211212
23333333333333333333212
22222222223333332222222
22333333333332222222222
22222222333333333332222