10 10
2222222222
2111111112
2133333312
2133333312
2133223312
2133223312
2133333312
2133333312
2111111112
2222222222